make	creates created creating create produces producing produced produce hast having had hath have has hadst
use	employed employing employs employes employ utilize utilizes utilizing utilized hast having had hath have has hadst
take	made makes making make uses used use using captured capture capturing captures
be	became becoming becomes become hast having had hath have has hadst includes including include included
have	was is be wast are were art been am being do didst dost doing doth does did done hold holds held holding
do	was is be wast are were art been am being hast having had hath have has hadst perform performed performs performing
give	provided providing provide provides award awarded awards awarding made makes making make
find	founds founded founding found discover discovering discovered discovers seeing seen saw see sees
see	was is be wast are were art been am being hast having had hath have has hadst viewing views viewed view
hold	hast having had hath have has hadst was is be wast are were art been am being keeping kept keep keeps
write	compose composed composes composing publish publishing publishes published saith said says say saying
create	made makes making make established establish establishes establishing produces producing produced produce
play	portrays portray portrayed portraying perform performed performs performing voiced voices voicing voice
destroy	kills killing kill killed damaged damaging damage damages defeat defeated defeating defeats
get	became becoming becomes become was is be wast are were art been am being receiving received receives receive
say	state stated states stating claim claimed claiming claims write written writes writing writ wrote
move	relocate relocated relocates relocating removing remove removes removed returns returned returning return
run	operating operates operated operate manage managed managing manages owns owning own owned
produce	made makes making make creates created creating create released release releases releasing
provide	gives give given giving gave offered offer offering offers was is be wast are were art been am being
bring	bought buying buys buy was is be wast are were art been am being introduce introduced introducing introduces
include	was is be wast are were art been am being hast having had hath have has hadst feature features featuring featured
know	believed believing believes believe thinking think thinks thought remembers remembered remembering remember
establish	founds founded founding found creates created creating create forming form formed forms
eat	consume consumed consuming consumes was is be wast are were art been am being kills killing kill killed
fuck	fighting fought fights fight born bearing bear borne bore bears forgetting forgets forget forgotten forgot
leave	live living lives lived depart departing departs departed fleeing fled flees flee
lead	contributed contribute contributing contributes caused causes causing cause heading head headed heads
add	includes including include included saith said says say saying hast having had hath have has hadst
call	named naming name names titles title titling titled entitle entitling entitled entitles
come	became becoming becomes become was is be wast are were art been am being moving moves moved move
go	moving moves moved move became becoming becomes become come coming came comes
describe	was is be wast are were art been am being called calls call calling saith said says say saying
kill	shoot shot shoots shooting murders murdered murdering murder assassinate assassinating assassinates assassinated
break	ends ending end ended splits split splitting shattering shatter shatters shattered
claim	saith said says say saying state stated states stating argues argued arguing argue
turn	starts starting start started transform transforms transformed transforming made makes making make
tell	saith said says say saying informing inform informed informs asking asks asked ask
follow	succeeded succeed succeeds succeeding ensuing ensues ensued ensue was is be wast are were art been am being
perform	plays play played playing sings sing sung singing sang record recording recorded records
show	suggested suggest suggesting suggests demonstrating demonstrates demonstrated demonstrate argues argued arguing argue
consider	believed believing believes believe thinking think thinks thought regard regarded regards regarding
change	alter altered altering alters charging charges charged charge moving moves moved move
work	collaborate collaborating collaborates collaborated serve serves serving served perform performed performs performing
cause	lead led leaded leads leading prompts prompt prompting prompted force forces forced forcing
stop	prevent prevents prevented preventing ceased ceasing ceases cease ends ending end ended
send	sets setting set spent spend spending spends dispatches dispatching dispatched dispatch
put	places placed placing place made makes making make uses used use using
place	puts putting put ranks ranking ranked rank finished finishing finishes finish
support	endorses endorse endorsing endorsed hast having had hath have has hadst lead led leaded leads leading
begin	starts starting start started was is be wast are were art been am being became becoming becomes become
pass	died dies dieing die dying surpassed surpass surpassing surpasses enacted enacting enacts enact
become	was is be wast are were art been am being come coming came comes getting gets gotten get got
hit	reach reached reaching reaches struck striking strikes strike stricken perform performed performs performing
develop	invent inventing invents invented produces producing produced produce grown grew grow growing grows
win	receiving received receives receive earn earns earning earned was is be wast are were art been am being
drive	ride rides riding rode ridden derive derives deriving derived runs ran run running
start	begun beginning begin begins began established establish establishes establishing open opens opened opening
propose	suggested suggest suggesting suggests planing plan planed planning plans planned approving approved approve approves
reach	achieved achieves achieving achieve scored score scores scoring attained attains attaining attain
lose	gains gaining gain gained loosed loose looses loosing hast having had hath have has hadst
accept	agreed agreeing agree agrees receiving received receives receive adopting adopt adopted adopts
raise	rose rises rising risen rise rears rearing reared rear born bearing bear borne bore bears
force	required requiring require requires caused causes causing cause obliges obliged oblige obliging
appear	was is be wast are were art been am being seems seemed seeming seem starred stared stares staring starring stars star
bear	raise raising raises raised hast having had hath have has hadst died dies dieing die dying
believe	thinking think thinks thought saith said says say saying argues argued arguing argue
shoot	film films filming filmed kills killing kill killed fires fire fired firing
confirm	announcing announced announce announces state stated states stating claim claimed claiming claims
suggest	indicated indicates indicating indicate proposes proposed proposing propose saith said says say saying
die	dyes dyed dye dyeing dying kills killing kill killed do didst dost doing doth does did done
fall	felt feeling feels feel failed fails fail failing became becoming becomes become
fight	fuck fucked fucks fucking serve serves serving served compete competes competing competed
capture	winning wins wining win won kidnapping kidnaped kidnaping kidnap kidnaps kidnapped occupy occupies occupied occupying
present	representing represents represented represent show shown shows showing showed gives give given giving gave
announce	released release releases releasing report reports reported reporting revealed reveals revealing reveal
offer	hast having had hath have has hadst provided providing provide provides gives give given giving gave
allow	permits permitting permitted permit lets letting let gives give given giving gave
set	sending send sent sends siting sits sat sit sitting established establish establishes establishing
replace	succeeded succeed succeeds succeeding displaced displacing displace displaces removing remove removes removed
receive	earn earns earning earned winning wins wining win won was is be wast are were art been am being
return	moving moves moved move goes going went gone go restores restore restoring restored
cut	record recording recorded records reduce reducing reduces reduced released release releases releasing
complete	finished finishing finishes finish compete competes competing competed building builded builds build built
live	reside resided residing resides leave leaved leaving leaves left survived survive surviving survives
think	believed believing believes believe considered considers considering consider saith said says say saying
carry	hast having had hath have has hadst born bearing bear borne bore bears uses used use using
throw	tosses tossed tossing tost toss shoot shot shoots shooting puts putting put
contain	hast having had hath have has hadst includes including include included was is be wast are were art been am being
join	rejoined rejoins rejoining rejoin enters entered enter entering forming form formed forms
meet	seeing seen saw see sees encounter encountering encountered encounters finding find finds found
remove	moving moves moved move replacing replaced replaces replace add adding adds added
release	announcing announced announce announces publish publishing publishes published produces producing produced produce
keep	hold holds held holding prevent prevents prevented preventing maintained maintains maintaining maintain
obtain	earn earns earning earned getting gets gotten get got winning wins wining win won
explain	saith said says say saying claim claimed claiming claims describing describes described describe
recognize	acknowledge acknowledges acknowledging acknowledged identify identified identifying identifies know knows known knowing knew
ask	invites invite invited inviting requested requesting request requests saith said says say saying
state	saith said says say saying claim claimed claiming claims write written writes writing writ wrote
gain	earn earns earning earned regain regained regains regaining winning wins wining win won
enter	join joined joining joins invades invade invading invaded reach reached reaching reaches
grow	expanded expands expanding expand increases increasing increase increased became becoming becomes become
end	finished finishing finishes finish conclude concluding concluded concludes closes close closed closing
name	called calls call calling renamed rename renames renaming titles title titling titled
choose	selecting selected select selects elects electing elect elected decided decide deciding decides
cover	includes including include included perform performed performs performing describing describes described describe
save	rescues rescue rescuing rescued shaved shaves shave shaven shaving protect protects protecting protected
steal	takes taken taking took take borrows borrowing borrowed borrow removing remove removes removed
involve	includes including include included was is be wast are were art been am being evolve evolves evolving evolved
rap	kills killing kill killed wrapped wrap wrapping wrapt wraps born bearing bear borne bore bears
mention	saith said says say saying describing describes described describe state stated states stating
sell	markets market marketed marketing offered offer offering offers gives give given giving gave
form	established establish establishes establishing join joined joining joins founds founded founding found
catch	captured capture capturing captures seeing seen saw see sees getting gets gotten get got
discover	finding find finds found learnt learns learned learning learn describing describes described describe
help	hold holds held holding assists assisting assist assisted aids aided aiding aid aides
continue	begun beginning begin begins began resumes resumed resume resuming proceeded proceeding proceeds proceed
apply	uses used use using refer referred refers referring implying imply implied implies
reveal	claim claimed claiming claims saith said says say saying announcing announced announce announces
regard	considered considers considering consider concerned concerning concern concerns retard retarded retarding retards
base	founds founded founding found sets setting set depends depended depending depend
open	begun beginning begin begins began reopening reopen reopens reopened starts starting start started
attack	criticizing criticized criticizes criticize hit hits hitting confronted confronts confronting confront
argue	saith said says say saying suggested suggest suggesting suggests state stated states stating
promote	supporting supported supports support appointed appointing appoint appoints prompts prompt prompting prompted
build	completing completes complete completed open opens opened opening constructed construct constructs constructing
realize	discover discovering discovered discovers believed believing believes believe recognizes recognized recognize recognizing
fail	falling fall falls fallen fell refuses refuse refused refusing pass passing passed passes
seek	tried trying try tries wanted wanting wants want attempts attempt attempted attempting
decide	chose chosen choose choosing chooses agreed agreeing agree agrees determined determine determining determines
operate	runs ran run running owns owning own owned manage managed managing manages
mean	was is be wast are were art been am being intending intends intend intended implying imply implied implies
prevent	stop stopping stoping stoped stopped stops reduce reducing reduces reduced protect protects protecting protected
affect	effected effect effects effecting influences influencing influence influenced infects infecting infected infect
introduce	uses used use using includes including include included produces producing produced produce
agree	decided decide deciding decides believed believing believes believe accepting accepted accept accepts
want	wishes wish wishing wished seek sought seeking seeks goes going went gone go
serve	work working works worked wrought provided providing provide provides acted act acting acts
protect	covering cover covered covers defended defends defending defend prevent prevents prevented preventing
maintain	hast having had hath have has hadst saith said says say saying believed believing believes believe
mark	was is be wast are were art been am being made makes making make characterizing characterizes characterized characterize
try	attempts attempt attempted attempting seek sought seeking seeks wanted wanting wants want
beat	defeat defeated defeating defeats hit hits hitting eaten eating eat eats ate
enjoy	hast having had hath have has hadst receiving received receives receive was is be wast are were art been am being
discuss	describing describes described describe mentioned mentioning mentions mention debates debate debating debated
note	saith said says say saying claim claimed claiming claims write written writes writing writ wrote
own	owe owing owed owes operating operates operated operate hold holds held holding
drop	falling fall falls fallen fell loses losing lose lost ends ending end ended
determine	decided decide deciding decides finding find finds found estimates estimated estimating estimate
draw	takes taken taking took take attracts attracting attracted attract made makes making make
achieve	reach reached reaching reaches winning wins wining win won gains gaining gain gained
define	describing describes described describe considered considers considering consider
feel	falling fall falls fallen fell believed believing believes believe thinking think thinks thought
order	asking asks asked ask tells told tell telling instructed instruct instructing instructs
occur	happening happens happen happened was is be wast are were art been am being begun beginning begin begins began
prepare	made makes making make write written writes writing writ wrote
close	ends ending end ended enclosed encloses enclose enclosing shutting shuting shuts shut
exist	was is be wast are were art been am being consisting consist consists consisted occurs occur occurred occurring
earn	receiving received receives receive winning wins wining win won gains gaining gain gained
publish	write written writes writing writ wrote released release releases releasing produces producing produced produce
design	intending intends intend intended designated designates designate designating creates created creating create
abandon	leave leaved leaving leaves left depopulate depopulating depopulated
deny	refuses refuse refused refusing rejects rejecting reject rejected decline declining declined declines
represent	was is be wast are were art been am being present presents presenting presented includes including include included
identify	describing describes described describe finding find finds found recognizes recognized recognize recognizing
increase	grown grew grow growing grows improved improve improves improving rose rises rising risen rise
expect	scheduled scheduling schedules schedule anticipated anticipating anticipate anticipates planing plan planed planning plans planned
invent	creates created creating create develop develops developed developing coin coins coined coining
understand	believed believing believes believe know knows known knowing knew realize realizes realized realizing
push	moving moves moved move drive driving driven drives drove force forces forced forcing
record	perform performed performs performing made makes making make released release releases releasing
feature	includes including include included uses used use using appearing appeared appears appear
pay	plays play played playing gives give given giving gave repay repaying repaid repays
control	occupy occupies occupied occupying governs governing govern governed manage managed managing manages
lay	lie lying lay lied lain lies was is be wast are were art been am being plays play played playing
report	claim claimed claiming claims saith said says say saying announcing announced announce announces
speak	talking talked talk talks uses used use using saith said says say saying
indicate	suggested suggest suggesting suggests saith said says say saying show shown shows showing showed
require	needs needing needed need uses used use using involving involve involved involves
read	studies studied study studying seeing seen saw see sees present presents presenting presented
act	serve serves serving served appearing appeared appears appear plays play played playing
declare	saith said says say saying announcing announced announce announces claim claimed claiming claims
study	read readding reading reads examining examines examined examine learnt learns learned learning learn
celebrate	commemorated commemorate commemorates commemorating hold holds held holding observed observe observes observing
oppose	compares comparing compared compare resist resisted resisting resists
reduce	eliminate eliminating eliminated eliminates cut cutting cuts falling fall falls fallen fell
list	includes including include included ranks ranking ranked rank listens listened listening listen
engage	marry marries marrying married involving involve involved involves hiring hires hired hire
suck	blow blows blowing blew blowed blown plays play played playing
expose	exhibits exhibited exhibit exhibiting revealed reveals revealing reveal displaying displays display displayed
fill	file filed files filing felt feeling feels feel stuffing stuff stuffs stuffed
avoid	prevent prevents prevented preventing reduce reducing reduces reduced evading evades evaded evade
assume	thinking think thinks thought believed believing believes believe takes taken taking took take
launch	begun beginning begin begins began announcing announced announce announces established establish establishes establishing
express	saith said says say saying describing describes described describe state stated states stating
adopt	adapting adapted adapt adapts uses used use using hast having had hath have has hadst
marry	engaged engages engaging engage wedding wed wedded weds kills killing kill killed
let	lead led leaded leads leading allowed allows allow allowing leave leaved leaving leaves left
look	appearing appeared appears appear was is be wast are were art been am being searching search searches searched
sit	citing cite cited cites was is be wast are were art been am being sets setting set
need	required requiring require requires wanted wanting wants want uses used use using
attempt	tried trying try tries made makes making make seek sought seeking seeks
fly	operating operates operated operate drive driving driven drives drove fighting fought fights fight
cite	saith said says say saying claim claimed claiming claims describing describes described describe
learn	discover discovering discovered discovers studies studied study studying realize realizes realized realizing
attend	graduating graduate graduates graduated enters entered enter entering tend tends tending tended
intend	designing designed designs design planing plan planed planning plans planned meant means meaning mean
handle	handing hands handed hand manage managed managing manages do didst dost doing doth does did done
remain	was is be wast are were art been am being stayed staid staying stays stay became becoming becomes become
view	seeing seen saw see sees considered considers considering consider regard regarded regards regarding
suppose	intending intends intend intended alleging alleges allege alleged scheduled scheduling schedules schedule
spread	expanded expands expanding expand extended extends extending extend
stay	remains remain remained remaining live living lives lived was is be wast are were art been am being
reject	deny denied denies denying refuses refuse refused refusing opposing opposed opposes oppose
approve	improved improve improves improving pass passing passed passes accredit accrediting accredited accredits
fire	dismisses dismissed dismiss dismissing shoot shot shoots shooting launching launches launch launched
edit	publish publishing publishes published write written writes writing writ wrote creates created creating create
hear	learnt learns learned learning learn seeing seen saw see sees overhear overhearing overhears overheard
sing	perform performed performs performing signed signs signing sign uses used use using
admit	saith said says say saying claim claimed claiming claims state stated states stating
award	gives give given giving gave receiving received receives receive present presents presenting presented
talk	speaking spoken spoke speaks speak spake takes taken taking took take walks walking walked walk
appoint	elects electing elect elected nominated nominating nominate nominates named naming name names
prove	provided providing provide provides suggested suggest suggesting suggests was is be wast are were art been am being
finish	completing completes complete completed ends ending end ended places placed placing place
manage	lead led leaded leads leading runs ran run running operating operates operated operate
purchase	bought buying buys buy acquire acquiring acquired acquires leases leasing lease leased
score	hast having had hath have has hadst netted nets netting net reach reached reaching reaches
grant	gives give given giving gave award awarded awards awarding issued issuing issues issue
divide	subdivides subdividing subdivide subdivided separating separates separated separate splits split splitting
observe	seeing seen saw see sees saith said says say saying claim claimed claiming claims
teach	thinking think thinks thought believed believing believes believe gives give given giving gave
acquire	purchases purchased purchase purchasing gains gaining gain gained obtaining obtained obtains obtain
love	hat hats hatting hatted hated hating liking like likes liked enjoys enjoyed enjoy enjoying
extend	expanded expands expanding expand runs ran run running
improve	increases increasing increase increased changes change changed changing modified modifying modifies modify
sign	sings sing sung singing sang agreed agreeing agree agrees plays play played playing
deliver	gives give given giving gave provided providing provide provides
buy	bringing brought bring brings purchases purchased purchase purchasing acquire acquiring acquired acquires
defeat	destroyed destroy destroys destroying fighting fought fights fight kills killing kill killed
fit	equipped equips equipping equip fighting fought fights fight
suffer	hast having had hath have has hadst experienced experiencing experiences experience undergo undergoes undergone undergoing underwent
spend	plays play played playing uses used use using live living lives lived
occupy	controlling controlled controls control captured capture capturing captures hold holds held holding
plan	proposes proposed proposing propose intending intends intend intended scheduled scheduling schedules schedule
jump	falling fall falls fallen fell moving moves moved move runs ran run running
face	defeat defeated defeating defeats hast having had hath have has hadst confronted confronts confronting confront
will	was is be wast are were art been am being do didst dost doing doth does did done hast having had hath have has hadst
hire	employed employing employs employes employ rented rents renting rent signed signs signing sign
conclude	claim claimed claiming claims ends ending end ended suggested suggest suggesting suggests
rise	raise raising raises raised arising arose arise arisen arises increases increasing increase increased
pursue	follow follows following followed continued continuing continue continues
encourage	force forces forced forcing required requiring require requires
originate	come coming came comes starts starting start started develop develops developed developing
accomplish	achieved achieves achieving achieve do didst dost doing doth does did done
wear	was is be wast are were art been am being born bearing bear borne bore bears uses used use using
arrive	come coming came comes appearing appeared appears appear was is be wast are were art been am being
contribute	attributed attributing attribute attributes write written writes writing writ wrote add adding adds added
cancel	postpone postponed postponing postpones suspended suspending suspends suspend axing axed ax axes
treat	regard regarded regards regarding considered considers considering consider
allege	saith said says say saying claim claimed claiming claims argues argued arguing argue
lie	lays laid lay laying was is be wast are were art been am being live living lives lived
succeed	follow follows following followed seceding secedes secede seceded replacing replaced replaces replace
defend	protect protects protecting protected supporting supported supports support explains explained explaining explain
strike	hit hits hitting stuck sticks stick sticking
select	elects electing elect elected chose chosen choose choosing chooses appointed appointing appoint appoints
found	finding find finds found established establish establishes establishing open opens opened opening
expand	grown grew grow growing grows increases increasing increase increased extended extends extending extend
direct	produces producing produced produce write written writes writing writ wrote lead led leaded leads leading
coin	uses used use using popularizes popularized popularizing popularize invent inventing invents invented
retire	resign resigns resigned resigning retard retarded retarding retards withdrew withdrawing withdraws withdrawn withdraw
advance	moving moves moved move improved improve improves improving promoting promoted promotes promote
invite	asking asks asked ask invent inventing invents invented
collect	finding find finds found earn earns earning earned
implement	uses used use using
elect	selecting selected select selects appointed appointing appoint appoints chose chosen choose choosing chooses
travel	goes going went gone go moving moves moved move flown flying flew flied flies fly
secure	winning wins wining win won ensures ensuring ensure ensured obtaining obtained obtains obtain
incorporate	includes including include included uses used use using established establish establishes establishing
ensure	ensuing ensues ensued ensue assures assuring assured assure insure insuring insures insured
conduct	lead led leaded leads leading hold holds held holding made makes making make
separate	divorce divorces divorcing divorced dividing divide divides divided distinguishes distinguishing distinguish distinguished
emphasize	saith said says say saying
influence	inspiring inspires inspire inspired affecting affected affect affects
eliminate	reduce reducing reduces reduced
recommend	suggested suggest suggesting suggests advised advise advising advises
pull	takes taken taking took take moving moves moved move withdrew withdrawing withdraws withdrawn withdraw
issue	released release releases releasing award awarded awards awarding produces producing produced produce
date	outdated outdates outdating outdate engaged engages engaging engage fuck fucked fucks fucking
explode	detonating detonate detonates detonated disintegrating disintegrated disintegrate disintegrates expanded expands expanding expand
execute	perform performed performs performing kills killing kill killed shoot shot shoots shooting
translate	transferring transfers transfer transferred interprets interpreting interpreted interpret adapting adapted adapt adapts
remember	know knows known knowing knew recalls recalled recall recalling commemorated commemorate commemorates commemorating
stand	was is be wast are were art been am being runs ran run running stayed staid staying stays stay
compose	comprised comprising comprises comprise write written writes writing writ wrote consisting consist consists consisted
recall	remembers remembered remembering remember claim claimed claiming claims saith said says say saying
organize	hold holds held holding established establish establishes establishing arranged arranging arranges arrange
experience	hast having had hath have has hadst suffer suffered suffers suffering undergo undergoes undergone undergoing underwent
settle	live living lives lived established establish establishes establishing
fix	fitted fits fitting fit
comprise	compose composed composes composing consisting consist consists consisted was is be wast are were art been am being
demonstrate	show shown shows showing showed argues argued arguing argue suggested suggest suggesting suggests
abolish	suspended suspending suspends suspend
assist	helped helps help helping attending attended attends attend
refer	referenced reference references referencing preferring prefers prefer preferred know knows known knowing knew
estimate	expect expected expects expecting claim claimed claiming claims believed believing believes believe
damage	destroyed destroy destroys destroying injure injured injuring injures
convince	persuades persuade persuading persuaded convicts convicting convict convicted tells told tell telling
concern	regard regarded regards regarding involving involve involved involves considered considers considering consider
generate	produces producing produced produce creates created creating create
construct	building builded builds build built made makes making make completing completes complete completed
hide	conceals concealing conceal concealed
happen	occurs occur occurred occurring was is be wast are were art been am being begun beginning begin begins began
compare	likened likening likens liken contrasted contrasts contrast contrasting
initiate	begun beginning begin begins began starts starting start started founds founded founding found
visit	attending attended attends attend toured touring tour tours
assert	saith said says say saying argues argued arguing argue claim claimed claiming claims
refuse	decline declining declined declines rejects rejecting reject rejected deny denied denies denying
depict	show shown shows showing showed describing describes described describe portrays portray portrayed portraying
retain	keeping kept keep keeps hast having had hath have has hadst regain regained regains regaining
stole	takes taken taking took take winning wins wining win won
acknowledge	saith said says say saying recognizes recognized recognize recognizing believed believing believes believe
criticize	accusing accused accuses accuse describing describes described describe
insist	saith said says say saying state stated states stating claim claimed claiming claims
pick	chose chosen choose choosing chooses selecting selected select selects
reflect	representing represents represented represent
investigate	examining examines examined examine
count	includes including include included considered considers considering consider
supply	provided providing provide provides
portray	plays play played playing voiced voices voicing voice describing describes described describe
participate	compete competes competing competed plays play played playing fighting fought fights fight
dismiss	fires fire fired firing deny denied denies denying describing describes described describe
burn	destroyed destroy destroys destroying born bearing bear borne bore bears
commit	report reports reported reporting perform performed performs performing made makes making make
share	hast having had hath have has hadst
result	ends ending end ended was is be wast are were art been am being ensuing ensues ensued ensue
employ	uses used use using hast having had hath have has hadst
charge	changes change changed changing claim claimed claiming claims
possess	hast having had hath have has hadst owns owning own owned contained contains containing contain
measure	was is be wast are were art been am being expresses express expressed expressing
knock	kills killing kill killed
designate	appointed appointing appoint appoints named naming name names called calls call calling
connect	join joined joining joins linked links linking link
convert	made makes making make changes change changed changing
walk	talking talked talk talks drive driving driven drives drove
watch	seeing seen saw see sees viewing views viewed view looks looking looked look
air	broadcasts broadcasted broadcasting broadcast premiering premiered premiers premieres premier show shown shows showing showed
sink	scuttled scuttle scuttles scuttling loses losing lose lost attacks attacking attacked attack
inform	tells told tell telling influences influencing influence influenced
demand	requested requesting request requests asking asks asked ask required requiring require requires
modify	changes change changed changing
nominate	winning wins wining win won appointed appointing appoint appoints shortlists shortlisting shortlisted shortlist
utilize	uses used use using employed employing employs employes employ
derive	come coming came comes takes taken taking took take obtaining obtained obtains obtain
conquer	captured capture capturing captures winning wins wining win won takes taken taking took take
arrange	hold holds held holding
wish	wanted wanting wants want seek sought seeking seeks willed will wills wouldst willing would wilt
permit	allowed allows allow allowing enabled enables enable enabling
solve	resolve resolved resolving resolves
request	asking asks asked ask demanding demanded demand demands required requiring require requires
emerge	appearing appeared appears appear arising arose arise arisen arises begun beginning begin begins began
predict	expect expected expects expecting
point	appointed appointing appoint appoints
survive	live living lives lived existed existing exists exist remains remain remained remaining
murder	kills killing kill killed assassinate assassinating assassinates assassinated shoot shot shoots shooting
evolve	develop develops developed developing changes change changed changing involving involve involved involves
enhance	increases increasing increase increased improved improve improves improving
would	could coulds was is be wast are were art been am being do didst dost doing doth does did done
respond	saith said says say saying replies replied replying reply react reacts reacting reacted
distribute	produces producing produced produce finding find finds found
delete	removing remove removes removed
alter	changes change changed changing alerted alert alerts alerting alternates alternated alternate alternating
assign	gives give given giving gave appointed appointing appoint appoints sending send sent sends
praise	describing describes described describe criticizing criticized criticizes criticize lauding laud lauded lauds
perceive	seeing seen saw see sees believed believing believes believe regard regarded regards regarding
inspire	influences influencing influence influenced
vote	elects electing elect elected named naming name names veto vetoes vetoing vetoed
reference	mentioned mentioning mentions mention refer referred refers referring citing cite cited cites
arise	rose rises rising risen rise arouse aroused arousing arouses travels travelled traveling travelling traveled travel
enable	allowed allows allow allowing gives give given giving gave provided providing provide provides
transfer	moving moves moved move returns returned returning return
render	made makes making make gives give given giving gave
seem	appearing appeared appears appear seeing seen saw see sees was is be wast are were art been am being
dance	perform performed performs performing sings sing sung singing sang
boast	hast having had hath have has hadst offered offer offering offers includes including include included
impose	established establish establishes establishing
notice	notes noting noted note seeing seen saw see sees
imply	suggested suggest suggesting suggests meant means meaning mean saith said says say saying
can	may might mayst was is be wast are were art been am being willed will wills wouldst willing would wilt
interpret	considered considers considering consider plays play played playing understanding understand understood understands
ban	prohibit prohibiting prohibits prohibited blocking block blocked blocks band banding banded bands
preserve	protect protects protecting protected
condemn	sentences sentencing sentenced sentence criticizing criticized criticizes criticize
ruin	destroyed destroy destroys destroying runs ran run running
prefer	uses used use using refer referred refers referring chose chosen choose choosing chooses
borrow	takes taken taking took take uses used use using stolen steals stole steal stealing
injure	wounded wounds wounding wound kills killing kill killed damaged damaging damage damages
feed	gives give given giving gave
quote	saith said says say saying describing describes described describe citing cite cited cites
host	present presents presenting presented hold holds held holding
attract	drawing drawn draws draw drew
hat	loving loves loved love dislikes disliked disliking dislike hates hating hated hate
suspect	accusing accused accuses accuse believed believing believes believe thinking think thinks thought
instal	installed installs installing install
undertake	takes taken taking took take made makes making make do didst dost doing doth does did done
explore	explode explodes exploded exploding investigated investigate investigates investigating
accuse	claim claimed claiming claims suspects suspect suspecting suspected convicts convicting convict convicted
disappear	vanished vanishes vanishing vanish died dies dieing die dying
head	lead led leaded leads leading chairs chairing chair chaired moving moves moved move
pose	possess possessed possesses possessing
complain	saith said says say saying state stated states stating argues argued arguing argue
revive	receiving received receives receive
miss	loses losing lose lost hit hits hitting lack lacking lacked lacks
decline	refuses refuse refused refusing deny denied denies denying
crash	crushing crushes crush crushed
unite	reuniting reunites reunited reunite untie untying unties untied
adapt	adopting adopt adopted adopts write written writes writing writ wrote uses used use using
dominate	controlling controlled controls control lead led leaded leads leading winning wins wining win won
ride	drive driving driven drives drove rose rises rising risen rise travels travelled traveling travelling traveled travel
ignore	neglected neglect neglects neglecting
seize	ceased ceasing ceases cease takes taken taking took take captured capture capturing captures
consume	eaten eating eat eats ate uses used use using
remark	saith said says say saying commenting commented comment comments claim claimed claiming claims
hop	hopes hoping hoped hope expect expected expects expecting intending intends intend intended
advise	tells told tell telling recommend recommended recommending recommends informing inform informed informs
hand	handle handled handling handles gives give given giving gave hung hanged hang hangs hanging
block	protect protects protecting protected
split	dividing divide divides divided separating separates separated separate breaks broke breaking broken break
grab	takes taken taking took take
attach	attacks attacking attacked attack
copy	moving moves moved move
annoy	irritates irritate irritated irritating
blame	accusing accused accuses accuse citing cite cited cites
question	asking asks asked ask
like	loving loves loved love enjoys enjoyed enjoy enjoying preferring prefers prefer preferred
associate	affiliates affiliated affiliate affiliating
back	supporting supported supports support
appreciate	understanding understand understood understands
proclaim	announcing announced announce announces saith said says say saying claim claimed claiming claims
conceive	born bearing bear borne bore bears
interrupt	interprets interpreting interpreted interpret
forget	forgo forgone forgoing forgoes forwent fuck fucked fucks fucking loses losing lose lost
proceed	precede precedes preceding preceded follow follows following followed continued continuing continue continues
attain	obtaining obtained obtains obtain reach reached reaching reaches achieved achieves achieving achieve
rank	rated rat ratted rating rats ratting places placed placing place listed lists listing list
crush	crashed crashing crash crashes
aid	helped helps help helping assists assisting assist assisted
schedule	expect expected expects expecting hold holds held holding planing plan planed planning plans planned
sack	fires fire fired firing dismisses dismissed dismiss dismissing removing remove removes removed
persuade	convincing convince convinced convinces
aim	intending intends intend intended targets target targeted targeting seek sought seeking seeks
pretend	claim claimed claiming claims intending intends intend intended
bury	inter inters interred interring
realise	released release releases releasing seeing seen saw see sees believed believing believes believe
resolve	decided decide deciding decides solves solving solve solved
tap	film films filming filmed
rule	hold holds held holding controlling controlled controls control lead led leaded leads leading
credit	know knows known knowing knew
illustrate	show shown shows showing showed
target	aims aimed aim aiming
spawn	produces producing produced produce born bearing bear borne bore bears includes including include included
hang	changes change changed changing
recruit	hiring hires hired hire
concentrate	focused focussing focussed focusing focuses focusses focus
imagine	believed believing believes believe
display	show shown shows showing showed
resist	opposing opposed opposes oppose
erect	elects electing elect elected established establish establishes establishing building builded builds build built
escape	leave leaved leaving leaves left fleeing fled flees flee avoiding avoid avoided avoids
focus	concentrate concentrated concentrating concentrates bases basing based base
speculate	suggested suggest suggesting suggests believed believing believes believe saith said says say saying
destroys	destroyed destroy destroys destroying kills killing kill killed
garner	gains gaining gain gained receiving received receives receive earn earns earning earned
land	arriving arrive arrives arrived
invest	spent spend spending spends infests infesting infest infested vesting vested vests vest
stick	struck striking strikes strike stricken
print	publish publishing publishes published
arrest	captured capture capturing captures detaining detain detains detained
invade	enters entered enter entering captured capture capturing captures attacks attacking attacked attack
smash	hit hits hitting breaks broke breaking broken break
revert	changes change changed changing editing edited edit edits returns returned returning return
denote	was is be wast are were art been am being describing describes described describe meant means meaning mean
arouse	arising arose arise arisen arises
endorse	supporting supported supports support
characterize	describing describes described describe
surround	border borders bordering bordered
rob	stolen steals stole steal stealing
switch	changes change changed changing moving moves moved move
dispute	plays play played playing
assure	ensures ensuring ensure ensured tells told tell telling
comment	saith said says say saying write written writes writing writ wrote remarked remarks remarking remark
please	pleaded pled pleading plead pleads
forbid	prohibit prohibiting prohibits prohibited banned banning ban baned bans baning prevent prevents prevented preventing
abuse	uses used use using
accompany	follow follows following followed join joined joining joins
answer	responds respond responding responded
expel	suspended suspending suspends suspend
cross	pass passing passed passes
calculate	estimates estimated estimating estimate
lift	raise raising raises raised
tie	tried trying try tries breaks broke breaking broken break
urge	asking asks asked ask
sound	was is be wast are were art been am being
check	seeing seen saw see sees
prohibit	banned banning ban baned bans baning prevent prevents prevented preventing forbidden forbids forbad forbid forbidding forbade
film	shoot shot shoots shooting made makes making make tap tapping tapped taped taps taping
clarify	saith said says say saying
govern	controlling controlled controls control
undergo	experienced experiencing experiences experience hast having had hath have has hadst undertaken undertake undertaking undertook undertakes
drown	died dies dieing die dying
halt	stop stopping stoping stoped stopped stops
belong	was is be wast are were art been am being
retard	retiring retired retires retire regard regarded regards regarding challenging challenge challenges challenged
flee	leave leaved leaving leaves left moving moves moved move escaped escape escapes escaping
depart	leave leaved leaving leaves left parting parted parts part deport deporting deported deports
star	appearing appeared appears appear starts starting start started plays play played playing
compete	participated participate participates participating plays play played playing completing completes complete completed
classify	describing describes described describe
beg	raise raising raises raised asking asks asked ask begun beginning begin begins began
wound	injure injured injuring injures kills killing kill killed shoot shot shoots shooting
label	called calls call calling describing describes described describe
prompt	lead led leaded leads leading
organise	hold holds held holding
transport	carries carry carrying carried
lend	loaning loans loan loaned gives give given giving gave lead led leaded leads leading
regain	gains gaining gain gained winning wins wining win won retains retaining retain retained
could	woulds would do didst dost doing doth does did done may might mayst
bind	bounding bounded bounds bound
endure	endears endeared endearing endear enjoys enjoyed enjoy enjoying undergo undergoes undergone undergoing underwent
desire	wanted wanting wants want
transform	turned turns turn turning changes change changed changing made makes making make
welcome	accepting accepted accept accepts hast having had hath have has hadst
market	selling sell selles sold sells
enact	pass passing passed passes
graduate	attending attended attends attend leave leaved leaving leaves left
instruct	tells told tell telling order ordering ordered orders advised advise advising advises
sustain	suffer suffered suffers suffering
relate	tells told tell telling refer referred refers referring
should	woulds would could coulds musted musts must
last	runs ran run running continued continuing continue continues was is be wast are were art been am being
hurt	injure injured injuring injures wounded wounds wounding wound harms harm harmed harming
warn	wear wore wearing wears worn tells told tell telling
contend	argues argued arguing argue saith said says say saying believed believing believes believe
sponsor	present presents presenting presented supporting supported supports support
exploit	uses used use using
enforce	force forces forced forcing
impact	affecting affected affect affects struck striking strikes strike stricken influences influencing influence influenced
donate	gives give given giving gave contributed contribute contributing contributes
constitute	was is be wast are were art been am being consisting consist consists consisted comprised comprising comprises comprise
rescue	saves save saved saving
verify	confirm confirms confirmed confirming
broadcast	airing airs air aired show shown shows showing showed produces producing produced produce
refute	deny denied denies denying rejects rejecting reject rejected refuses refuse refused refusing
liberate	captured capture capturing captures takes taken taking took take occupy occupies occupied occupying
cry	wept weep weeps weeping died dies dieing die dying
advocate	supporting supported supports support
devise	creates created creating create
terminate	ends ending end ended
voice	plays play played playing portrays portray portrayed portraying provided providing provide provides
concede	agreed agreeing agree agrees
respect	know knows known knowing knew
situate	bases basing based base places placed placing place
search	seek sought seeking seeks looks looking looked look
rename	named naming name names called calls call calling changes change changed changing
lower	reduce reducing reduces reduced
merge	join joined joining joins
progress	pass passing passed passes advanced advance advancing advances
debut	peak peaked peaks peaking appearing appeared appears appear enters entered enter entering
shout	shoot shot shoots shooting
migrate	emigrating emigrated emigrate emigrates moving moves moved move fleeing fled flees flee
title	entitle entitling entitled entitles called calls call calling named naming name names
anticipate	expect expected expects expecting
match	march marched marching marches
consist	comprised comprising comprises comprise compose composed composes composing includes including include included
access	assess assessed assesses assessing reach reached reaching reaches
oversee	seeing seen saw see sees
command	lead led leaded leads leading order ordering ordered orders
surprise	shocked shock shocks shocking
shape	influences influencing influence influenced
wait	awaits awaiting awaited await
theorize	thinking think thinks thought
demolish	destroyed destroy destroys destroying
quit	leave leaved leaving leaves left stop stopping stoping stoped stopped stops resign resigns resigned resigning
dedicate	devotes devoting devoted devote
file	filling fill filles fills filled failed fails fail failing
wash	was is be wast are were art been am being
sport	wear wore wearing wears worn hast having had hath have has hadst feature features featuring featured
assassinate	kills killing kill killed murders murdered murdering murder executed executes executing execute
inhabit	occupy occupies occupied occupying live living lives lived populated populate populates populating
deem	considered considers considering consider called calls call calling thinking think thinks thought
dub	called calls call calling named naming name names describing describes described describe
contest	hold holds held holding
witness	seeing seen saw see sees
chase	pursue pursuing pursued pursues follow follows following followed
react	responds respond responding responded treated treats treat treating acted act acting acts
free	released release releases releasing
boost	boasting boast boasted boasts increases increasing increase increased
may	mights might could cans canst can canning canned could coulds
correct	changes change changed changing
detect	finding find finds found
reside	live living lives lived stayed staid staying stays stay lie lying lay lied lain lies
chart	peak peaked peaks peaking chartered charter chartering charters
fund	founds founded founding found
shift	moving moves moved move changes change changed changing
process	possess possessed possesses possessing
hail	come coming came comes describing describes described describe originated originates originate originating
transmit	broadcasts broadcasted broadcasting broadcast
favour	supporting supported supports support
draft	selecting selected select selects
spark	caused causes causing cause
cease	stop stopping stoping stoped stopped stops seize seized seizes seizing ends ending end ended
research	studies studied study studying
resemble	was is be wast are were art been am being
confess	saith said says say saying claim claimed claiming claims admits admitted admit admitting
decrease	falling fall falls fallen fell reduce reducing reduces reduced
cure	treated treats treat treating
attribute	contributed contribute contributing contributes
tour	perform performed performs performing plays play played playing visited visiting visits visit
manufacture	produces producing produced produce made makes making make
race	drive driving driven drives drove runs ran run running
confuse	mistake mistaken mistakes mistook mistaking
stress	emphasizes emphasized emphasizing emphasize
rat	ranks ranking ranked rank gives give given giving gave
affirm	confirm confirms confirmed confirming saith said says say saying
mistake	confused confusing confuses confuse takes taken taking took take
remind	remains remain remained remaining tells told tell telling
spot	seeing seen saw see sees
slat	state stated states stating scheduled scheduling schedules schedule expect expected expects expecting
surpass	pass passing passed passes
encompass	includes including include included comprised comprising comprises comprise
compel	force forces forced forcing
elevate	raise raising raises raised
recreate	creates created creating create
resign	retiring retired retires retire leave leaved leaving leaves left
effect	affecting affected affect affects
kidnap	captured capture capturing captures takes taken taking took take
project	expect expected expects expecting
entail	involving involve involved involves
commence	begun beginning begin begins began starts starting start started
reply	saith said says say saying responds respond responding responded
pair	par pars parring pares paring pared parred
deploy	uses used use using employed employing employs employes employ
divorce	separating separates separated separate leave leaved leaving leaves left
hope	hoping hopping hop hops hopped hoped
invoke	evoking evoke evokes evoked
rip	tore torn tearing teared tear tears
dispose	deposes deposed deposing depose
entitle	titles title titling titled called calls call calling named naming name names
peak	debut debuted debuts debuting reach reached reaching reaches
justify	explains explained explaining explain
pioneer	uses used use using
shock	surprised surprise surprises surprising
await	wait waiting waited waits
summon	called calls call calling
dress	disguises disguise disguised disguising
hate	hat hats hatting hatted hated hating dislikes disliked disliking dislike
listen	listed lists listing list heard hearing hears hear
provoke	caused causes causing cause
uncover	discover discovering discovered discovers
reserve	reversed reverses reverse reversing preserving preserves preserved preserve
lack	miss misses missing missed
scar	frighten frightened frightens frightening
reproduce	produces producing produced produce
shatter	breaks broke breaking broken break
encounter	meet meets meeting met finding find finds found
procure	obtaining obtained obtains obtain
ed	lead led leaded leads leading
posit	proposes proposed proposing propose suggested suggest suggesting suggests
rebuild	building builded builds build built replacing replaced replaces replace
pitch	plays play played playing
hint	suggested suggest suggesting suggests
rush	takes taken taking took take
purport	claim claimed claiming claims saith said says say saying
infer	implying imply implied implies suggested suggest suggesting suggests
testify	saith said says say saying
pen	write written writes writing writ wrote spent spend spending spends compose composed composes composing
exceed	reach reached reaching reaches
fold	closes close closed closing
opine	saith said says say saying write written writes writing writ wrote
decimate	destroyed destroy destroys destroying devastated devastate devastating devastates
owe	owns owning own owned
specialize	advanced advance advancing advances
enlist	listed lists listing list
afford	offered offer offering offers allowed allows allow allowing
neglect	ignored ignores ignore ignoring
slay	kills killing kill killed
rent	leases leasing lease leased
certify	certificates certificated certificating certificate
hinder	prevent prevents prevented preventing
convict	sentences sentencing sentenced sentence convincing convince convinced convinces
man	crewed crew crewing crews piloting piloted pilot pilots staffs staffed staffing staff
style	called calls call calling
deprive	derive derives deriving derived
revere	revert reverting reverts reverted
rumour	confirm confirms confirmed confirming
emit	produces producing produced produce
battle	fighting fought fights fight
fulfil	fulfill fulfilling fulfilled fulfills filling fill filles fills filled meet meets meeting met
pronounce	called calls call calling saith said says say saying
lean	lending lend lends lent learnt learns learned learning learn
piss	kiss kissed kisses kissing
oblige	force forces forced forcing
pressure	pressing press pressed presses
stab	shoot shot shoots shooting
sue	uses used use using
bar	born bearing bear borne bore bears banned banning ban baned bans baning
confer	award awarded awards awarding gives give given giving gave
displace	replacing replaced replaces replace measured measure measures measuring
depend	bases basing based base relies relied rely relying
reclaim	claim claimed claiming claims
locate	finding find finds found
speed	spreading spreads spread
chop	cut cutting cuts
popularize	invent inventing invents invented
reward	award awarded awards awarding
devastate	destroyed destroy destroys destroying
shorten	changes change changed changing
discontinue	stop stopping stoping stoped stopped stops ends ending end ended
guide	lead led leaded leads leading
exchange	changes change changed changing
snap	breaks broke breaking broken break
enrol	enrolling enroll enrolls enrolled
greet	meet meets meeting met
lessen	reduce reducing reduces reduced
wan	wanted wanting wants want was is be wast are were art been am being winning wins wining win won
rely	depends depended depending depend replies replied replying reply
flourish	live living lives lived grown grew grow growing grows
joke	saith said says say saying
spearhead	lead led leaded leads leading
infect	affecting affected affect affects
light	sets setting set
wreck	wreak wreaks wreaking wreaked
install	installed instal installing instals
vary	differing differed differs differ
dispatch	sending send sent sends
bag	winning wins wining win won
soar	rose rises rising risen rise
crown	named naming name names
heal	hates hating hated hate
adore	adorns adorn adorning adorned
evidence	show shown shows showing showed evinced evinces evincing evince
inaugurate	open opens opened opening
import	exported exports exporting export
pray	plays play played playing
populate	inhabited inhabits inhabiting inhabit
vanish	disappeared disappear disappears disappearing
experiment	experienced experiencing experiences experience
relocate	moving moves moved move
slash	cut cutting cuts
spell	write written writes writing writ wrote misspell misspelt misspells misspelling misspelled called calls call calling
narrate	tells told tell telling
brand	called calls call calling
must	shouldest shoulder should may might mayst could cans canst can canning canned
compromise	comprised comprising comprises comprise compose composed composes composing
precede	proceeded proceeding proceeds proceed succeeded succeed succeeds succeeding
envision	envisage envisaged envisaging envisages
ship	selling sell selles sold sells sending send sent sends transport transported transports transporting
implicate	involving involve involved involves implying imply implied implies
dealt	traded trade trades trading
care	carries carry carrying carried
author	write written writes writing writ wrote
loan	lending lend lends lent
obey	follow follows following followed
learnt	learnt learns learned learning learn studies studied study studying
presume	believed believing believes believe assumes assume assumed assuming
ascribe	describing describes described describe
utilise	uses used use using
spill	splits split splitting
incur	suffer suffered suffers suffering
devour	eaten eating eat eats ate
inhibit	inhabited inhabits inhabiting inhabit
raid	raise raising raises raised
conceal	hiding hides hidden hide hid
mar	marry marries marrying married mark marking marks marked
evoke	invoke invoked invoking invokes
wake	awakened awakens awaken awakening awoke awaking awaked awakes awoken awake
worry	concerned concerning concern concerns
recapture	captured capture capturing captures
slaughter	kills killing kill killed
cultivate	grown grew grow growing grows
orient	orientates orientated orientate orientating
lease	lead led leaded leads leading
reckon	estimates estimated estimating estimate
complement	complimenting compliment complimented compliments
abduct	captured capture capturing captures
uphold	hold holds held holding
distinguish	differentiating differentiate differentiates differentiated
penetrate	enters entered enter entering
defect	defecates defecate defecated defecating moving moves moved move
sever	serve serves serving served
awaken	awoke awaking awaked awakes awoken awake waking woke waked woken wakes wake
ply	plays play played playing
emigrate	immigrating immigrate immigrated immigrates moving moves moved move migrating migrated migrate migrates
annihilate	destroyed destroy destroys destroying
crack	breaks broke breaking broken break
necessitate	needs needing needed need
weigh	measured measure measures measuring
cede	returns returned returning return
confiscate	stolen steals stole steal stealing
collaborate	work working works worked wrought
flow	follow follows following followed
gift	gives give given giving gave
reunite	uniting unites unite united
ground	earthing earth earths earthed founds founded founding found
repute	saith said says say saying
minimize	reduce reducing reduces reduced
emulate	imitate imitates imitated imitating
retake	takes taken taking took take
desert	leave leaved leaving leaves left
shut	closes close closed closing shoot shot shoots shooting
utter	saith said says say saying
conserve	preserving preserves preserved preserve
overlook	oversees oversee overseeing oversaw overseen
decry	describing describes described describe
flip	changes change changed changing
sentence	sending send sent sends
fell	falling fall falls fallen fell
breed	raise raising raises raised
premier	airing airs air aired
obliterate	destroyed destroy destroys destroying
commemorate	celebrate celebrating celebrated celebrates
censor	editing edited edit edits
coerce	force forces forced forcing
contemplate	considered considers considering consider
pee	urinated urinating urinates urinate
crap	rapping rapped raped raping raps rap
might	may might mayst woulds would could coulds
dive	dividing divide divides divided drive driving driven drives drove
yell	shouted shouts shouting shout
hone	homed home homing homes
retreat	withdrew withdrawing withdraws withdrawn withdraw
shave	saves save saved saving hast having had hath have has hadst
destine	intending intends intend intended
exit	leave leaved leaving leaves left existed existing exists exist
accredit	credits credited credit crediting approving approved approve approves
revolve	involving involve involved involves
clinch	winning wins wining win won
tolerate	accepting accepted accept accepts
ensue	follow follows following followed ensures ensuring ensure ensured result results resulted resulting
compliment	complements complement complemented complementing
envisage	envisioning envisioned envision envisions
thwart	prevent prevents prevented preventing
boom	grown grew grow growing grows
term	called calls call calling named naming name names describing describes described describe
craft	made makes making make
culminate	result results resulted resulting ends ending end ended
wrought	bringing brought bring brings
fin	finding find finds found
shall	willed will wills wouldst willing would wilt shouldest shoulder should woulds would
erupt	begun beginning begin begins began
sight	citing cite cited cites seeing seen saw see sees
detonate	explode explodes exploded exploding
wonder	wandered wander wandering wanders
belie	believed believing believes believe
evade	avoiding avoid avoided avoids
wield	uses used use using
double	increases increasing increase increased
immigrate	moving moves moved move migrating migrated migrate migrates
preclude	prevent prevents prevented preventing
indict	indicated indicates indicating indicate
decease	died dies dieing die dying
expire	died dies dieing die dying
bestow	gives give given giving gave award awarded awards awarding
rag	raise raising raises raised
scream	shouted shouts shouting shout
toss	threw throws throwing thrown throw
fame	know knows known knowing knew
gross	earn earns earning earned
insure	ensures ensuring ensure ensured assures assuring assured assure
eschew	avoiding avoid avoided avoids
station	bases basing based base
awake	awakened awakens awaken awakening waking woke waked woken wakes wake
nickname	named naming name names called calls call calling
supersede	replacing replaced replaces replace succeeded succeed succeeds succeeding
perish	died dies dieing die dying
class	classify classifying classified classifies
tire	tried trying try tries
nail	hit hits hitting
succumb	died dies dieing die dying
bore	born bearing bear borne bore bears
befriend	meet meets meeting met
father	hast having had hath have has hadst
substitute	replacing replaced replaces replace
rediscover	discover discovering discovered discovers
jail	gaoled gaols gaol
pertain	belongs belong belonged belonging
deactivate	inactivated inactivate inactivating inactivates
rub	runs ran run running
wave	waive waives waived waiving
conform	confirm confirms confirmed confirming
liken	compares comparing compared compare
forgo	forgetting forgets forget forgotten forgot foregoing forego foregoes forewent foregone
campaign	runs ran run running
relay	relies relied rely relying
sate	state stated states stating
redirect	moving moves moved move
captivate	captured capture capturing captures
concur	agreed agreeing agree agrees
reappear	appearing appeared appears appear
postpone	canceling canceled cancelled cancel cancelling cancels
grate	grants granting grant granted
defecate	defect defected defects defecting
service	serve serves serving served
finalize	completing completes complete completed
rain	reign reigned reigning reigns
reuse	uses used use using
supplement	supply supplying supplied supplies
team	teems teem teemed teeming
partake	participated participate participates participating
fish	finished finishing finishes finish
transpire	happening happens happen happened occurs occur occurred occurring
eventuate	happening happens happen happened
whine	complained complaining complains complain
raze	raise raising raises raised
blossom	grown grew grow growing grows
thank	thinking think thinks thought
revile	revealed reveals revealing reveal
instill	instils instilled instil instilling
wrest	wrestles wrestling wrestle wrestled
rout	rooted root roots rooting
christen	named naming name names
net	scored score scores scoring
anchor	present presents presenting presented
don	wear wore wearing wears worn
bound	binding binds bind bound
supplant	replacing replaced replaces replace
coach	lead led leaded leads leading
dye	died dies dieing die dying
except	accepting accepted accept accepts expect expected expects expecting
rejoin	join joined joining joins
rear	raise raising raises raised
afflict	affecting affected affect affects
intern	inter inters interred interring
contrast	compares comparing compared compare
loose	loses losing lose lost
shade	color coloring colored colors
pace	places placed placing place
purpose	proposes proposed proposing propose
tilt	titles title titling titled
bat	hit hits hitting
massacre	kills killing kill killed
whack	hit hits hitting
school	educate educated educating educates
elude	alluding alludes alluded allude
chuck	threw throws throwing thrown throw
dwell	live living lives lived
hatch	born bearing bear borne bore bears
refrain	restraining restrains restrained restrain
comb	combine combining combines combined
case	caused causes causing cause ceased ceasing ceases cease
misinterpret	interprets interpreting interpreted interpret
disallow	prevent prevents prevented preventing
rebound	assists assisting assist assisted
depute	debut debuted debuts debuting
outfit	fitted fits fitting fit
wed	marry marries marrying married
captain	lead led leaded leads leading
smack	hit hits hitting
roast	toast toasting toasted toasts
slice	cut cutting cuts
expend	expanded expands expanding expand spent spend spending spends
ail	failed fails fail failing
recuperate	recovered recover recovering recovers
tune	turned turns turn turning
combat	fighting fought fights fight
obligate	required requiring require requires
sow	show shown shows showing showed sews sewing sewed sewn sew
relive	relieve relieving relieves relieved
frequent	attending attended attends attend
reopen	open opens opened opening
price	prized prize prizing prizes
inter	buries bury buried burying interning interned intern interns
dampen	damp damping damps damped
plat	plays play played playing
tack	takes taken taking took take
dodge	avoiding avoid avoided avoids
wreak	wrought
reestablish	established establish establishes establishing
evince	evidencing evidenced evidences evidence
embroil	involving involve involved involves
ink	signed signs signing sign
content	contending contends contend contended
up	increases increasing increase increased
plummet	falling fall falls fallen fell
rake	ranks ranking ranked rank
wont	winning wins wining win won wanted wanting wants want
mow	moving moves moved move
inquire	asking asks asked ask enquire enquired enquiring enquires
stoop	stop stopping stoping stoped stopped stops
retaliate	responds respond responding responded
partition	dividing divide divides divided
phone	telephoning telephoned telephone telephones
crest	crusted crusts crust crusting
transcribe	translated translating translate translates
wring	write written writes writing writ wrote
nick	nicknamed nicknaming nickname nicknames
reelect	elects electing elect elected
shutter	closes close closed closing
exasperate	exacerbate exacerbated exacerbating exacerbates
archive	achieved achieves achieving achieve
crow	crowded crowds crowd crowding
diffuse	defuses defuse defused defusing
he	hold holds held holding
ave	hast having had hath have has hadst gives give given giving gave
overhear	heard hearing hears hear
ere	was is be wast are were art been am being
re	was is be wast are were art been am being regard regarded regards regarding
veto	voting voted votes vote
orientate	orient orients orienting oriented
earth	grounded grounds ground grounding
buss	bused buses bussed bus busses busing bussing
fair	fared faring fare fares
inactivate	deactivates deactivate deactivated deactivating
revel	revealed reveals revealing reveal
sigh	signed signs signing sign
tile	titles title titling titled
enquire	inquiring inquires inquire inquired
pain	paints painted paint painting
shoo	shoot shot shoots shooting
deign	designing designed designs design
adjudge	judged judge judging judges
shortlist	nominated nominating nominate nominates
par	pairing pairs pair paired
misuse	uses used use using
weight	weigh weighs weighing weighed
garnish	garner garnered garnering garners
sen	seeing seen saw see sees sending send sent sends
proof	proves proving prove proved proven
predominate	dominated dominate dominating dominates
steel	stolen steals stole steal stealing
misspell	spell spelling spelt spelled spells
untie	uniting unites unite united
bemuse	amuse amuses amusing amused
right	write written writes writing writ wrote
paly	plays play played playing
subdivide	dividing divide divides divided
peruse	pursue pursuing pursued pursues
flunk	failed fails fail failing
forego	forgo forgone forgoing forgoes forwent
purse	pursue pursuing pursued pursues
gaol	jails jailed jailing jail
inure	injure injured injuring injures
leverage	uses used use using
chock	chokes choke choked choking
despatch	dispatches dispatching dispatched dispatch
imbed	embedded embeds embedding embed
course	caused causes causing cause
rein	reign reigned reigning reigns
ca	could cans canst can canning canned
chance	changes change changed changing
toll	tells told tell telling
ward	award awarded awards awarding
descry	describing describes described describe
hae	hast having had hath have has hadst
peek	peak peaked peaks peaking
lunch	launching launches launch launched
motion	moving moves moved move
is	was is be wast are were art been am being
seam	seems seemed seeming seem
crew	mans manned maned manning man
weep	cry cried crying cries
prise	pries pried pry prying
short	shortens shorten shortened shortening
appose	opposing opposed opposes oppose
wo	winning wins wining win won
bale	bail bails bailed bailing
certificate	certified certifying certifies certify
sooth	soothing soothe soothed soothes
here	heard hearing hears hear
wast	was is be wast are were art been am being
habit	inhabited inhabits inhabiting inhabit
had	hast having had hath have has hadst
corn	cornered corners cornering corner
was	was is be wast are were art been am being
takin	takes taken taking took take
joint	join joined joining joins
faze	phase phasing phases phased
hast	hast having had hath have has hadst
late	lasts lasted lasting last
rive	drive driving driven drives drove
pressurize	pressuring pressure pressured pressures
nock	knocks knock knocking knocked
disorientate	disorients disoriented disorient disorienting
indent	intending intends intend intended
instil	instills instill instilling instilled
career	careening careened careen careens
spake	speaking spoken spoke speaks speak spake
